券	CRSpline
凄	UseOnlyAssemblyResources
凅	table_def
准	table_base
凇	table
凈	changeLangActions
凉	get_lang
凊	PlayerPrefsSetString
凋	PlayerPrefsGetString
凌	Get2LetterISOCodeFromSystemLanguage
凍	AddToDefault
凎	Translate
减	GetLocalizationKey
凐	_Localization
凑	SelectLocalizationName
凒	GetSelectedLocalizationName
凓	GetLanguageNames
凔	AddToChangeLang
凕	RemoveFromChangeLang
凖	LoadLocalizationFileFromText
凗	LocalizedResourcesLoad
凘	LocalizedResourcesLoad_type
凚	LoadDefaults
凛	_LoadDefaultResorceFile
凜	ReadFromAssemblyResources
凝	ReadFromAssemblyDirectory
凞	ReadFromUnityResorceAsset
凟	GetStringHash
几	FindInChangeLang
凡	VerifyString
凢	TestStr
凣	DeleteAll
凤	DeleteKey
凥	HasKey
処	Save
凧	GetFloat
凨	GetInt
凩	GetString
凪	SetFloat
凫	SetInt
凬	SetString
凭	GetStringHashAsHex
凮	ExpirationAfterMinutes
凯	expirationTime
凰	expirationTime2
凱	st_group
凲	st_text
凳	IsExpired
凴	IsExpiredLevel
凵	VerifyDemoModeExpirationTime
凶	VerifyDemoModeExpirationTimeOnGUI
凷	DrawExpirationMessage
凸	VerifyDemoModeExpirationTime_GUI
凹	expirationTime3
出	expirationTime4
击	resources
凼	GetResourcesList
函	GetResourceStream
凾	is2017
凿	LoadImage_bytes
刀	is_init
刁	LoadImage_2017
刂	EncodeToPNG_2017
刃	LoadImageCustom
刄	disableLocalization
刅	LoadEncryptedResourceDisbaleLocalization
分	LoadEncryptedResourceText
切	LoadEncryptedResourceBinary
刈	LoadEncryptedResourceTexture
刉	LoadEncryptedResourceTextureEx
刊	LoadEncryptedResourceMesh
刋	LoadEncryptedResourceAssetBundle
刌	LoadEncryptedResourceAssetObject
刍	_STRING_ENCRYPT_KEY
刎	Rnd
刏	GetDefaultEncryptPassword
刐	_DecryptStringFastInd
刑	_DecryptStringFast
划	DecryptStringUTF8
刓	EncryptStringUTF8
刔	DecryptStringBig
刕	def_headerSize
刖	SerializeMeshes
列	DeserializeMeshes
刘	WriteMesh
则	ReadMesh
刚	WriteMeshHeader
创	ReadMeshHeader
刜	WriteVertices
初	ReadVertices
刞	WriteTriangleIndicies
刟	ReadTriangleIndicies
删	_DefaultEncryptPassword
刡	prefix
刢	prefix2
刣	Decrypt
判	IsEncrypted
別	DecryptBytes
刦	Decrypt_GetMeta
刧	DecryptString
刨	$this
利	$current
刪	$disposing
别	$PC
刬	StringLocalization
刭	Test
刮	PlayerPrefsProtected
刯	DemoMode
到	ResourcesTools
刱	ImageConversionCustom
刲	ResourcesEncryption
刳	StrEncrypt
刴	BaseMeshSerializer
刵	Crypto
制	ApplyTween
刷	EasingFunction
凙`1	LocalizedResourcesLoad_Template
刹	tauntID
刺	player
刻	previousWeaponNum
刼	$locvar0
刽	$locvar1
刾	weaponNum
刿	zombieWeapon
剀	bytes
剁	mode
剂	StringLocalization
剃	Test
剄	PlayerPrefsProtected
剅	DemoMode
剆	ResourcesTools
則	ImageConversionCustom
剈	ResourcesEncryption
剉	StrEncrypt
削	BaseMeshSerializer
剋	Crypto
